......................... .........................
......................... .........................
......................... .........................
......................... .........................
......................... .........................
......................... .........................
......................... .........................
......................... .........................
......................... .........................
......................... .........................
......................... .........................
......................... .........................
......................... .........................
......................... .........................
......................... .........................
......................... .........................
......................... .........................
......................... .........................
......................... .........................
......................... .........................
......................... .........................
......................... .........................
.S....................... .........................
......................... .........................
......................... .........................

......................... .........................
......................... ..T....T5......T4........
.......R................. ...T3..............T.....
.H2...................... ...T........T4.T4..T2....
......................... ...............T.....T3..
......................... ..T................T4....
................H5....... ...T4....................
.......R...H1............ .........................
.H2...................... .T4......................
......................... ....T....................
.....P................... .T.......................
.....B...............H4.. .........................
.......R....R....R....... ..T.........E............
......................... .........................
......................... ..T4.....................
......................... ...T4....................
..H..................H4.. .........................
.......R...H2....R....... .TT3.....................
......................... .........................
......................... .T4......................
......................... .........................
.H3...................H.. ..TT4....................
.......R....H....R....... ....T.T4.................
......................... .T...T4............T5....
......................... .T4..T.T4................